#Lothia Majors
ISS = "countries/Isswyn.txt"
SLM = "countries/Solemyr.txt" 
NAS = "countries/Nasra.txt"
VRS = "countries/VorRos.txt"
KIR = "countries/Kiirsa.txt"
ARH = "countries/Arhna.txt"
HAA = "countries/Haanyr.txt"
NLO = "countries/NewLothia.txt"
LOH = "countries/LothianHorde.txt"

#Lothia Minors
AAM = "countries/AamasBan.txt"
AGR = "countries/Agraan.txt"
CER = "countries/Ceryll.txt"
EEG = "countries/VorEegan.txt"
ERS = "countries/ErsemGor.txt"
GAN = "countries/VorGanarr.txt"
HRR = "countries/Harragor.txt"
HII = "countries/VorHiirl.txt"
IIL = "countries/AldIilm.txt"
LYE = "countries/Lyem.txt"
MAA = "countries/VorMaalnag.txt"
MLN = "countries/Malnn.txt"
OSI = "countries/Osiia.txt"
SII = "countries/Siiray.txt"
VES = "countries/Vesvor.txt"


#South Gryphna Majors
AVB = "countries/AldVorBan.txt"
ANM = "countries/Annmark.txt"
AVE = "countries/Avenmyr.txt"
ENH = "countries/Enhwer.txt"
MKR = "countries/ManarKor.txt"
TGR = "countries/Thagarn.txt"
ROT = "countries/Rothian.txt"
ERK = "countries/ErpisKor.txt"
SOC = "countries/Soclann.txt"

#South Gryphna Minors
ARI = "countries/Agrior.txt"
EDE = "countries/Edean.txt"
GAE = "countries/Graen.txt"
OHN = "countries/OhanNor.txt"
TRG = "countries/Taragas.txt"
TRB = "countries/Trebus.txt"
URA = "countries/Uramor.txt"
VAH = "countries/VorAhnsera.txt"
VUL = "countries/VulgeinNor.txt"
ABL = "countries/AldBelna.txt"
APH = "countries/AldPhalan.txt"
ARU = "countries/Arulus.txt"
BRK = "countries/BuranKor.txt"
HBO = "countries/Harbon.txt"
SAB = "countries/Saban.txt"

#North Gryphna Majors
GRY = "countries/Gryphna.txt"
#ALM = "countries/Arlem.txt"
GRN = "countries/Gerron.txt"

